#	영어 텍스트 Atom
BULLET	&#149;
NEWLINE	\r\n
TOK_COMPANY	SAP
TOK_LIB	교육 과정
TOK_TOUR	학습
TOK_TRAINER	Desktop Assistant
TOK_AUTOMATION	epo
NAVIGATOR	Desktop Assistant
NAV_LIBRARY	library
BTN_ABORT	종료
BTN_CLOSE	종료
BTN_OK	확인
BTN_CLOSE_DLG	닫기
BTN_CONTINUE	계속
BTN_PREVIEW	미리보기
BTN_PROCEED	계속
BTN_RESTART	다시 시작
BTN_SKIP	단계 건너뛰기
BTN_START	시작
BTN_STOP	중지
BTN_EXECUTE	실행
CA_SWITCH	상황에 맞는 도움말
CONTENT_CAP	컨텐츠
MAIL_SUBJECT	데스크톱 보조 도구의 컨텐츠 요청
MAIL_HEADER	작성자님,\n\n 다음에 대한 컨텐츠를 요청하고자 합니다.
MAIL_FOOTER	- 프로세스/트랜잭션: 현재 사용 중인 애플리케이션 프로세스를 명시하십시오. \n\n- 설명: 필요한 정보를 명시하십시오. \n\n안녕하십니까,
MAIL_DATA	- 애플리케이션 이름:
MAIL_TOOLTIP	컨텐츠 요청
SHARE_TOOLTIP	컨텐츠 공유
REQUEST_TEXT	컨텐츠를 요청하려면 %s을(를) 클릭하십시오.
REQUEST_LINK	여기
SEARCH_CAP	검색
INFO_CAP	정보
SETTINGS_CAP	설정
BACK_TOOLTIP	뒤로
SHARE_CONTENT_TOOLTIP	컨텐츠 공유
CB_HIDE_OPTION	더 이상 표시하지 않음
MY_ROLES	내 역할
EDIT_ROLES	역할 변경
NO_ROLES	역할이 없는 컨텐츠 표시
SELECT_ALL_CAPTION	모두 선택
USER_CAPTION	사용자 영역
READ_MORE	더 읽기...
NO_CATEGORY_CAPTION	기타 컨텐츠
DELETE_FAILED	삭제 작업에 실패했습니다. 
RENAME_FAILED	이름 바꾸기 작업에 실패했습니다.
FILE_EXISTS	같은 이름의 파일이 이미 있습니다. 다른 이름을 입력하십시오.
LBL_YES	예
LBL_DELETE	삭제
LBL_NO	아니오
LBL_OK	확인
DELETE_DLG_TEXT	선택한 문서를 삭제하시겠습니까(%N)?
LBL_CONCURRENT	지원 모드 시작
LBL_DA	데스크톱 보조 도구
LBL_SIM	시뮬레이션 시작
LBL_CDOC	열기
LBL_DEMO	데모 모드 시작
LBL_NAVI	안내 동영상 시작
LBL_BOOK	책 재생
LBL_GROUP	library에서 열기
LBL_NAVIGATION	데스크톱 보조 도구
LBL_PA	안내 동영상
LBL_PRACTICE	연습 모드 시작
LBL_SIMULATION	시뮬레이션
LBL_BOOKPAGE	책 페이지 표시
LBL_TEST	테스트 모드 시작
LBL_RECORD_DOCUMENT	레코드 문서
MSG_AUTOMATION_FINISHED	자동화가 완료되었습니다.
MSG_AUTOMATION_FINISHED_2	자동화 프로세스를 다시 시작하려면 '다시 시작'을 클릭하십시오.
MSG_AUTOMATION_START	입력 값 편집
MSG_AUTOMATION_START_2	다음 값을 확인 또는 편집하십시오. 이 값은 프로세스가 진행되는 동안 자동으로 입력됩니다.
MSG_EPO_DIALOG	전자 프로세스 최적화
MSG_NAVI_LIBRARY_NO_APP	사용 가능한 정보가 없습니다.
LBL_NAVI_NO_MATCH	검색 결과가 없습니다.
NO_RECORDS	사용 가능한 문서가 없습니다. 
MSG_NAVI_LIBRARY_SUBTITLE	사용 가능한 컨텐츠:
MSG_NAVI_LIBRARY_TITLE	데스크톱 보조 도구
MSG_NOT_APPLICABLE	편집할 수 없음
MSG_PA_CONTROL_STEP	이 단계의 필수 액션:
MSG_PA_EXPLANATION_STEP	아래 표시된 화면을 탐색합니다.
MSG_PA_FORM_STEP	양식에서 입력할 필수 필드:
MSG_PA_DIALOG	안내 동영상
MSG_PA_START_SCREEN	시작 화면을 여십시오.
MSG_PA_STEP_NOT_FOUND	필수 화면으로 이동하십시오.
MSG_PA_STEP_NOT_FOUND1	대상 애플리케이션(@{TARGETAPPNAME})이 열려 있는지 확인하십시오.
MSG_PA_STEP_NOT_FOUND2	아래 표시된 컨트롤이 하이라이트된 화면을 탐색합니다.
MSG_STEP_LIGHT	단계 미리보기
MSG_STEP_NOT_FOUND	안내 동영상 단계가 없습니다.
MSG_STEP_NOT_FOUND_2	대상 애플리케이션의 제목 표시줄을 클릭하거나 오른쪽 화면으로 이동하십시오.<br><br>필요한 화면을 보려면 '미리보기'를 클릭하십시오.
PA_FINISHED	안내 동영상 종료됨
PROJECT_TITLE	프로젝트 제목
TRAY_INFO_BUBBLE_HEADING	안내 동영상
TRAY_INFO_BUBBLE_TEXT	다음 단계를 표시할 수 없습니다. 자세한 내용은 여기를 클릭하십시오.
RESTRICTED_BUBBLE_HEADING	작업이 보류됨
RESTRICTED_BUBBLE_TEXT	현재 단계를 확인할 때까지 작업을 실행할 수 없습니다. 
HELP_TITLE	도움말
HELP_INTRO	이 도움말은 @{NAVIGATOR}의 주요 부분 및 기능에 대한 개요를 제공합니다.</br></br><b>참고:</b> 사용 가능한 기능은 @{NAVIGATOR}의 구성에 따라 달라집니다.</br>
HELP_TITLE_DA	사이드바 및 윈도우
HELP_SIDEBAR_T	사이드바
HELP_SIDEBAR_H	사이드바를 사용하여 @{NAVIGATOR}의 주 기능을 시작할 수 있습니다. 각 기능에 대한 버튼이 표시됩니다. 끌어서 놓기를 사용하여 사이드바를 이동할 수 있으며 사이드바 경계를 클릭하여 최소화 및 최대화할 수 있습니다.
HELP_CONTENT_CONTROL_T	컨텐츠
HELP_CONTENT_CONTROL_H	컨텐츠를 사용할 수 있는지 여부를 나타내고 컨텐츠가 있는 주 창을 엽니다.
HELP_SEARCH_CONTROL_T	검색
HELP_SEARCH_CONTROL_H	컨텐츠를 검색하기 위해 검색을 엽니다.
HELP_EXTSEARCH_CONTROL_T	외부 검색
HELP_EXTSEARCH_CONTROL_H	컨텐츠를 검색하기 위해 외부 검색을 엽니다.
HELP_STICKY_CONTROL_T	스티커 메모 추가
HELP_STICKY_CONTROL_H	현재 애플리케이션 창에 대한 스티커 메모를 삽입합니다. 스티커 메모의 텍스트를 입력할 수 있습니다.
HELP_RECORDING_CONTROL_T	녹화 시작
HELP_RECORDING_CONTROL_H	프로세스 녹화를 시작합니다. 녹화된 프로세스는 사용자 영역의 문서로 저장됩니다. 
HELP_MAIN_WINDOW_T	주 창
HELP_MAIN_WINDOW_H	주 창에는 특정 페이지 컨텍스트에 대한 가용 컨텐츠가 표시됩니다.</br>안내 동영상 재생 시 창에 단계 목록이 표시됩니다.
HELP_HEADER_T	헤더
HELP_HEADER_H	헤더에 있는 상태 아이콘은 현재의 컨텍스트에 대한 컨텐츠가 있는지를 나타냅니다.
HELP_CONTENT_TAB_T	컨텐츠 탭
HELP_CONTENT_TAB_H	이 탭에는 현재 애플리케이션에 사용할 수 있는 컨텐츠가 표시됩니다.
HELP_CONTENT_VIEW_T	컨텐츠 보기
HELP_CONTENT_VIEW_H	컨텐츠 보기에는 선택한 컨텐츠에 사용 가능한 정보, 모드 및 문서가 표시됩니다.</br>'뒤로' 컨트롤을 사용하면 컨텐츠 목록으로 다시 돌아갈 수 있습니다.
HELP_SEARCH_TAB_T	검색 탭
HELP_SEARCH_TAB_H	이 탭에서는 현재의 컨텍스트에 관한 특정 컨텐츠를 검색할 수 있습니다.
HELP_INFO_TAB_T	정보 탭
HELP_INFO_TAB_H	탭에 @{NAVIGATOR}에 대한 일반 정보가 표시됩니다.
HELP_USERAREA_TAB_T	사용자 영역 탭
HELP_USERAREA_TAB_H	이 탭에는 녹화된 프로세스 문서가 있습니다. 문서를 열거나 공유하거나 삭제할 수 있습니다. 프로세스를 추가로 녹화할 수도 있습니다. 
HELP_INSTANT_T	빠른 도움말
HELP_INSTANT_H	설정이 활성화되면 현재 애플리케이션 화면의 오른쪽에 추가 컨텍스트 정보가 표시됩니다. 이 설정은 기본적으로 활성화됩니다.
HELP_REQCONTENT_T	컨텐츠 요청
HELP_REQCONTENT_H	누락된 컨텐츠를 작성자에게 요청하기 위해 전자메일 창을 엽니다.
HELP_SETTINGS_T	설정
HELP_SETTINGS_H	이 뷰에는 @{NAVIGATOR} 컨텐츠를 표시하기 위한 설정이 포함되어 있습니다.
HELP_MYROLES_T	내 역할
HELP_MYROLES_H	이 설정은 지정된 역할의 컨텐츠를 표시합니다.
HELP_WITHOUTROLES_T	역할이 없는 컨텐츠 표시
HELP_WITHOUTROLES_H	이 설정은 지정된 역할이 없는 컨텐츠를 표시합니다.
HELP_EDITROLES_T	역할
HELP_EDITROLES_H	컨텐츠에 사용되는 모든 역할이 나열되고 이 역할은 컨텐츠의 표시를 활성화하거나 비활성화할 수 있습니다.
HELP_SHARECONTENT_T	컨텐츠 공유
HELP_SHARECONTENT_H	컨텐츠에 대한 링크가 있는 대화 상자를 엽니다. 이 링크는 다른 사용자와 공유할 수 있습니다.
HELP_REQUESTCONTENT_T	컨텐츠 요청
HELP_REQUESTCONTENT_H	특정 컨텐츠를 요청하기 위해 미리 정의된 전자메일을 엽니다.
HELP_PLAYBACK_CONTENT_T	컨텐츠 재생
HELP_PLAYBACK_CONTENT_H	사용 가능한 컨텐츠는 컨텐츠 창에 있는 버튼을 사용하여 시작하거나 열 수 있습니다.
HELP_MINIMIZED_STATUS_T	최소화 상태
HELP_MINIMIZED_STATUS_H	주 창을 닫아도 유동 상태의 아이콘을 통해, 현재 컨텍스트에 컨텐츠를 사용 가능한지 계속 알 수 있습니다. 해당 아이콘을 클릭하면 주 창이 복원됩니다.
HELP_MINIMIZED_MENU_T	단축 메뉴
HELP_MINIMIZED_MENU_H	단축 메뉴(아이콘을 마우스 오른쪽 버튼으로 클릭)에는 주 창과 상황에 맞는 도움말을 표시할 수 있는 기능이 포함되어 있습니다.
HELP_BOOK_WINDOW_T	책 윈도우
HELP_BOOK_WINDOW_H	책을 재생할 때 책 윈도우가 열립니다. 주 윈도우 및 컨텐츠 윈도우가 숨겨집니다.
HELP_GOTOTOP	최상위로 이동
HELP_CAPTION	@{NAVIGATOR} 도움말
NAVHELP_TITLE	상태 아이콘 및 단축 메뉴
NAVHELP_INTRO	</br>이 도움말은 상태 아이콘 및 단축 메뉴 엔트리에 대한 개요를 제공합니다.
NAVHELP_STATUS_ICON_T	상태 아이콘(작업 표시줄)
NAVHELP_STATUS_ICON_H	상태 아이콘은 작업 표시줄에 위치하며 @{NAVIGATOR}의 현재 액티비티를 보여 줍니다. 다음과 같은 상태를 가집니다.
NAVHELP_STATUS_FOUND_T	컨텐츠 사용 가능(녹색 아이콘)
NAVHELP_STATUS_FOUND_H	현재 컨텍스트의 가용 컨텐츠가 있으며 해당 컨텐츠가 표시됩니다.
NAVHELP_STATUS_CHECK_T	컨텐츠 로드 중(노란색 아이콘)
NAVHELP_STATUS_CHECK_H	@{NAVIGATOR}이(가) 가용 컨텐츠의 현재 컨텍스트를 점검한 후 컨텐츠를 로드합니다.
NAVHELP_STATUS_NOFOUND_T	사용 가능한 컨텐츠 없음(빨간색 아이콘)
NAVHELP_STATUS_NOFOUND_H	현재 컨텍스트에 대한 가용 컨텐츠가 없습니다.
NAVHELP_STANDBY_T	사용 안 함
NAVHELP_STANDBY_H	@{NAVIGATOR}이(가) 비활성화되었습니다. 상태 아이콘을 클릭(<i>CTRL + F11</i>)하여 @{NAVIGATOR}을(를) 비활성화하거나 활성화합니다.
NAVHELP_STATUS_MIN_T	최소화됨
NAVHELP_STATUS_MIN_H	창과 사이드바가 최소화되었습니다.
NAVHELP_STATUS_MENU_T	단축 메뉴
NAVHELP_STATUS_MENU_H	단축 메뉴(아이콘에서 마우스 오른쪽 버튼 클릭)에 @{NAVIGATOR}의 일반 기능이 있습니다.
NAVHELP_VERSION_T	버전 표시
NAVHELP_VERSION_H	설치된 @{NAVIGATOR}의 버전 번호가 표시됩니다. 이 기능은 문제 발생 시 SAP Support에 문의할 때 필요합니다.
NAVHELP_JSCONSOLE_T	JavaScript 콘솔
NAVHELP_JSCONSOLE_H	자세한 오류 메시지를 볼 수 있는 JavaScript 콘솔을 표시합니다. 이 기능은 문제 발생 시 SAP Support에 문의할 때 필요합니다.
NAVHELP_NAV_CACHE_T	로컬 캐시 삭제
NAVHELP_NAV_CACHE_H	@{NAVIGATOR} 컨텐츠의 로컬 캐시를 삭제합니다.
NAVHELP_RESET_HIDDEN_T	숨겨진 모든 도움말 다시 표시
NAVHELP_RESET_HIDDEN_H	재생하는 동안 '숨김'으로 설정된 도움말 요소를 재설정합니다.
NAVHELP_EXIT_T	종료
NAVHELP_EXIT_H	재생을 중지하고 @{NAVIGATOR}을(를) 닫습니다.
IDS_NAVP_ABOUT	버전 표시...
IDS_NAVP_CONSOLE	JavaScript 콘솔...
IDS_NAVP_DELETE_CACHE	로컬 캐시 삭제
IDS_NAVP_HOOKER	후커
IDS_SEARCH_INPUT	검색 도움말 컨텐츠
IDS_CLEAR_SEARCH	검색 지우기
IDS_NAVP_CLOSE	종료
IDS_RESET_CURRENT	숨겨진 도움말 요소 다시 표시
IDS_RESET_ALL	숨겨진 모든 도움말 다시 표시
IDS_RESET_ALL_TIP	처음 화면을 입력할 때 비활성화된 모든 힌트 표시
IDS_OPEN_RECORD_LBL	열기
IDS_EDIT_RECORD_LBL	이름 변경
IDS_DELETE_RECORD_LBL	삭제
IDS_SHARE_RECORD_LBL	공유
IDS_EXTERNAL_SEARCH_BTN	외부 검색
IDS_EXTERNAL_SEARCH_SUB_MENU	외부 검색
IDS_SHOW_SCREEN_ICON	데스크톱 보조 도구 표시
IDS_SHOW_DA	주 창 표시
IDS_SHOW_CONTENT	컨텐츠 표시
IDS_HIDE_CONTENT	컨텐츠 숨기기
IDS_SEARCH_BTN	검색
IDS_REQUEST_CONTENT_BTN	컨텐츠 요청
IDS_RECORDING_BTN	녹화 시작
IDS_SHOW_CA_SWITCH	상황에 맞는 도움말 표시
IDS_HIDE_CA_SWITCH	상황에 맞는 도움말 숨기기
IDS_CA_SWITCH_INACTIVE_BTN	상황에 맞는 도움말 없음
IDS_DO_CTX_RECOGNITION	상황에 맞는 도움말 표시
IDS_NAV_STANDBY	@{NAVIGATOR}을(를) 사용할 수 없습니다.
IDS_NAV_NO_STANDBY	@{NAVIGATOR}을(를) 사용할 수 있습니다.
IDS_SHOW_DA_PANELS	이제 @{NAVIGATOR}을(를) 다시 사용할 수 있습니다. 지원이 필요한 경우 @{NAVIGATOR}을(를) 사용할 수 있습니다.
IDS_HIDE_DA_PANELS	현재 열려 있는 어플리케이션에서 적절한 도움말을 사용할 수 있어 @{NAVIGATOR}이(가) 자동으로 사라졌습니다. 추가 도움이 필요하면 어플리케이션에서 도움말을 여십시오.
IDS_ADD_STICKY_NOTES_BTN	스티커 메모 추가
IDS_ADD_STICKY_NOTES_INACTIVE_BTN	이 애플리케이션에 대해 스티커 메모를 하나만 추가할 수 있습니다.
IDS_EXIT_DA	종료
IDS_EXIT_DA_BTN	종료
IDS_EXIT_DA_SUB_MENU	종료
IDS_SHOW_MORE	더 표시
IDS_HIDE_MORE	더 숨기기
IDS_REQUEST_CONTENT_SUB_MENU	컨텐츠 요청
IDS_SHOW_CA_SUB_MENU	상황에 맞는 도움말 표시
IDS_HIDE_CA_SUB_MENU	상황에 맞는 도움말 숨기기
IDS_ADD_STICKY_NOTE_SUB_MENU	스티커 메모 추가
IDS_RECORDING_SUB_MENU	녹화 시작
IDS_CA_SWITCH_SUB_MENU	상황에 맞는 도움말
IDS_SHARE_DLG_CAPTION	문서 공유
IDS_DELETE_FRAMES	프레임 삭제
OPEN_FOLDER	폴더 열기
SHARE_DOC	전자메일을 통해 공유
IDS_SHARE_DLG_TEXT	원하는 작업을 선택하십시오.
IDS_SEARCH_BTN_SUB_MENU	컨텐츠 검색
IDS_LIBRARY_SEARCH_BTN_SUB_MENU	library의 컨텐츠 검색
GRACEFUL_DEGRADATION	네트워크 문제가 있어서 이 기능을 일시적으로 사용할 수 없습니다. \n\n나중에 다시 시도하십시오.
SHARE_BTN	전자메일을 통해 공유
COPY_BTN	링크 복사
SHARE_MAIL_SUBJECT	권장 컨텐츠
SHARE_MAIL_HEADER	안녕하십니까? \n\n 도움이 될만한 컨텐츠에 관해 알려 드립니다. \n\n
SHARE_MAIL_FOOTER	감사합니다.
SHARE_MAIL_LINK	링크:\t
SHARE_MAIL_CAPTION	캡션:\t
SHARE_TITLE	컨텐츠 공유
SELECT_ASSET	시작하려면 자산 선택
ENTER_NAME	이름 입력
DELETE_RECORD_WRN	중요: 이 액션을 취소할 수 없습니다.
MSG_PA_NEXT_LBL	다음
MSG_PA_STEP_LBL	단계 리스트
TOGGLE_STEPLIST_TOOLTIP	단계 목록 표시/숨기기
PREVIEW_STEP_TOOLTIP	미리보기 단계
NEXT_STEP_TOOLTIP	다음 단계로 이동
PREV_STEP_TOOLTIP	이전 단계로 이동
ROLES_TITLE	데스크톱 보조 도구 역할
ROLES_LBL	역할별 도움말 컨텐츠 필터링
OK_CAPTION	확인
CANCEL_CAPTION	취소
BTN_YES	예
BTN_NO	아니오
DELETE_CONFIRM	이 스티커 메모를 삭제하시겠습니까?
EXIT_CONFIRM	@{NAVIGATOR}을(를) 종료하시겠습니까?
sticky_notes	스티커 메모
exit_da	@{NAVIGATOR} 종료
STICKY_NOTE_DEFAULT_TEXT	여기에 텍스트를 추가하십시오.
SEARCH_BTN_TOOLTIP	검색
NEXT_BTN_TOOLTIP	다음
PREV_BTN_TOOLTIP	이전
HIDE_BTN_TOOLTIP	캐러셀 숨기기
IDS_PRJ_NAME	이름 입력:
IDS_APPLICATIONS	창 선택:
IDS_PRJ_LANGUAGE	언어 선택:
IDS_FULL_SCREEN	전체 화면
IDS_CHOOSE_APP_CAPTION	애플리케이션 선택
IDS_RECORD_BTN	녹화
IDS_ANALYZE_ACTIONS	작업 분석 중...
IDS_PARSE_PROJECT	프로젝트 구문 분석 중...
IDS_REGION	지역
IDS_AREA_HELP	아래 템플릿을 사용하여 지역 크기를 변경하십시오. 빨간색 직사각형의 크기를 조절하여 지역을 선택하거나 전체 화면을 선택하십시오.
IDS_CHOOSE_SIZE	크기 선택:
IDS_DEFINE_REC_AREA	녹화 영역
IDS_DEFINE_NAME_LANG	컨텐츠 생성
PLEASE_SELECT	다음을 선택하십시오. 
quick_recorder.help_caption	팁
quick_recorder.help	일시 중지하거나 계속하려면 "PAUSE" 키를 사용하십시오. \n종료하려면 "END" 키를 사용하십시오. \n\n녹음을 시작하려면 "확인"을 선택하십시오.
quick_recorder.audio_help	일시 중지하거나 계속하려면 "PAUSE" 키를 사용하십시오. \n종료하려면 "END" 키를 사용하십시오. \n\n오디오:\n클릭하는 동안에는 오디오가 녹음되지 않습니다. 컨트롤을 선택하기 전에 문장을 말하십시오. \n\n녹음을 시작하려면 "확인"을 선택하십시오.
FILE_EXISTS	같은 이름의 파일이 이미 있습니다. 다른 이름을 입력하십시오.
HELP_EXIT_CONTROL_H	재생을 중지하고 @{NAVIGATOR}을(를) 닫습니다.
HELP_EXIT_CONTROL_T	종료
BTN_CLOSE_DLG	닫기
DELETE_RECORD_WRN	중요: 이 액션을 취소할 수 없습니다.
ENTER_NAME	이름 입력
IDS_CLEAR_SEARCH	검색 지우기
IDS_RESET_ALL_TIP	처음 화면을 입력할 때 비활성화된 모든 힌트 표시
IDS_SEARCH_INPUT	검색 도움말 컨텐츠
LBL_DELETE	삭제
LBL_NAVI_NO_MATCH	검색 결과가 없습니다.
LBL_TU	열기
MSG_PA_NEXT_LBL	다음
MSG_PA_STEP_LBL	단계 리스트
RENAME_FAILED	이름 바꾸기 작업에 실패했습니다.
ROLES_LBL	역할별 도움말 컨텐츠 필터링
SELECT_ASSET	시작하려면 자산 선택
LBL_CDOC	열기
LBL_RECORD_DOCUMENT	레코드 문서
QR_CAPTION	녹화 출력 선택
QR_WELCOME	생성하시겠습니까?
QR_DOC_CAP	문서
QR_DOC_TXT	기록한 모든 작업에 대한 스크린샷과 설명문을 보여주는 Microsoft Word 문서를 생성합니다.
QR_VIDEO_CAP	비디오
QR_VIDEO_TXT	녹화의 고품질 비디오를 생성합니다.
QR_DOC_VIDEO_CAP	문서 및 비디오
QR_DOC_VIDEO_TXT	문서 및 비디오를 생성합니다.
SHARE_ERR_CAP	녹화를 공유할 수 없습니다.
SHARE_ERR_TXT	이 녹화는 너무 커서 전자메일을 통해 공유할 수 없습니다.\n대신 파일 위치를 여시겠습니까?
HELP_CONTENT_WINDOW_H	컨텐츠 창에는 주 창의 선택된 컨텐츠에 대한 가용 정보, 모드, 문서가 표시됩니다.</br>컨텐츠 창을 주 창에 도킹하면 화면에서 컨텐츠 창과 주 창을 함께 움직일 수 있습니다.
HELP_CONTENT_WINDOW_T	컨텐츠 창
IDS_CONTENT_BTN	컨텐츠
MSG_PA_STEP_NOT_FOUND_NUMERAL_1	1.
MSG_PA_STEP_NOT_FOUND_NUMERAL_2	2.
SHARE_URL	현재 페이지 URL:
