#	Στοιχεία Αγγλικού κειμένου
BULLET	&#149;
NEWLINE	\r\n
TOK_COMPANY	SAP
TOK_LIB	Μάθημα
TOK_TOUR	Μάθημα
TOK_TRAINER	Desktop Assistant
TOK_AUTOMATION	epo
NAVIGATOR	Desktop Assistant
NAV_LIBRARY	βιβλιοθήκη
BTN_ABORT	Εξοδος
BTN_CLOSE	Εξοδος
BTN_OK	ΟΚ
BTN_CLOSE_DLG	Κλείσιμο
BTN_CONTINUE	Συνέχεια
BTN_PREVIEW	Προεπισκόπηση
BTN_PROCEED	Συνέχεια
BTN_RESTART	Επανέναρξη
BTN_SKIP	Παράλειψη Βήματος
BTN_START	Εναρξη
BTN_STOP	Διακοπή
BTN_EXECUTE	Εκτέλεση
CA_SWITCH	Θεματική Βοήθεια
CONTENT_CAP	Περιεχ.
MAIL_SUBJECT	Απαίτηση Περιεχομένων για Βοηθό Επιφάνειας Εργασίας
MAIL_HEADER	Αγαπητέ δημιουργέ,\n\nθα ήθελα να ζητήσω περιεχόμενα για:
MAIL_FOOTER	Διαδικασία/Συναλλαγή: Παρακαλώ περιγράψτε την διαδικασία εφαρμογής που είναι σε χρήση τώρα \n\n- Περιγραφή: Παρακαλώ περιγράψτε τις πληροφορίες που χρειάζεστε. \n\nΜε εκτίμηση,
MAIL_DATA	- Ονομα Εφαρμογής:
MAIL_TOOLTIP	Απαίτηση Περιεχομένων
SHARE_TOOLTIP	Κοινή Χρήση Περιεχομένων
REQUEST_TEXT	Κάντε κλικ στο %s για να ζητήσετε περιεχόμενα 
REQUEST_LINK	εδώ
SEARCH_CAP	Αναζήτ
INFO_CAP	Πληροφ.
SETTINGS_CAP	Ρυθμίσεις
BACK_TOOLTIP	Πίσω
SHARE_CONTENT_TOOLTIP	Κοινή Χρήση Περιεχομένων
CB_HIDE_OPTION	Μην εμφανίσετε ξανά
MY_ROLES	Οι Ρόλοι Μου
EDIT_ROLES	Αλλαγή Ρόλων
NO_ROLES	Εμφάνιση Περιεχομένου Χωρίς Ρόλους
SELECT_ALL_CAPTION	Επιλογή Ολων
USER_CAPTION	Περιοχή Χρήστη
READ_MORE	Ανάγνωση περισσοτέρων...
NO_CATEGORY_CAPTION	Άλλο Περιεχόμενο
DELETE_FAILED	Διαγραφή απέτυχε.
RENAME_FAILED	Λειτουργία μετονομασίας απέτυχε.
FILE_EXISTS	Αρχείο με το ίδιο όνομα υπάρχει ήδη. Εισάγετε διαφορετικό όνομα.
LBL_YES	Ναι
LBL_DELETE	Διαγραφή
LBL_NO	Όχι
LBL_OK	Ok
DELETE_DLG_TEXT	Θέλετε να διαγράψετε τα επιλεγμένα έγγραφα (%N);
LBL_CONCURRENT	Εναρξη Ταυτόχρονης Λειτουργίας
LBL_DA	Βοηθός Επιφάνειας Εργασίας
LBL_SIM	Έναρξη Προσομοίωσης
LBL_CDOC	Ανοικτό
LBL_DEMO	Εναρξη Λειτουργίας Demo
LBL_NAVI	Εναρξη Πλοήγησης
LBL_BOOK	Βιβλίο Περιγραφής
LBL_GROUP	Άνοιγμα στην βιβλιοθήκη
LBL_NAVIGATION	Βοηθός Επιφάνειας Εργασίας
LBL_PA	Πλοήγηση
LBL_PRACTICE	Εναρξη Λειτουργίας Πρακτικής
LBL_SIMULATION	Προσομοίωση
LBL_BOOKPAGE	Εμφάνιση Σελίδας Βιβλίου
LBL_TEST	Εναρξη Λειτουργίας Ελέγχου
LBL_RECORD_DOCUMENT	Eγγραφή Αρχείου
MSG_AUTOMATION_FINISHED	Η αυτοματοποίηση ολοκληρώθηκε
MSG_AUTOMATION_FINISHED_2	Κάντε κλικ στο πλήκτρο 'Επανέναρξη', για να αρχίσ.ξανά την αυτοματοπ.διαδ.
MSG_AUTOMATION_START	Επεξεργασία τιμών εισόδου
MSG_AUTOMATION_START_2	Ελέγξτε ή επεξερ.τις ακόλ.τιμές. Αυτές θα καταχω.αυτόμ.κατά τη διαδικασία.
MSG_EPO_DIALOG	Βελτιστοποίηση Ηλεκτρονικής Διαδικασίας
MSG_NAVI_LIBRARY_NO_APP	Δεν υπάρχουν διαθέσιμες πληροφορίες.
LBL_NAVI_NO_MATCH	Δεν υπάρχουν αποτελέσματα για την αναζήτησή σας.
NO_RECORDS	Δεν υπάρχουν διαθέιμα έγγραφα.
MSG_NAVI_LIBRARY_SUBTITLE	Διαθέσιμα περιεχόμενα:
MSG_NAVI_LIBRARY_TITLE	Βοηθός Επιφάνειας Εργασίας
MSG_NOT_APPLICABLE	μη επεξεργάσιμο
MSG_PA_CONTROL_STEP	Απαραίτητη ενέργεια για το βήμα:
MSG_PA_EXPLANATION_STEP	Πλοήγηση στην οθόνη που εμφανίζεται παρακάτω.
MSG_PA_FORM_STEP	Υποχρεωτικά πεδία για να συμπληρωθούν στην φόρμα:
MSG_PA_DIALOG	Βοηθός Διαδικασίας
MSG_PA_START_SCREEN	Ανοιγμα αρχικής οθόνης.
MSG_PA_STEP_NOT_FOUND	Μεταβείτε στην απαραίτητη οθόνη
MSG_PA_STEP_NOT_FOUND1	Βεβαιωθείτε ότι η εφαρμογή στόχου (@{TARGETAPPNAME}) είναι ανοιχτή.
MSG_PA_STEP_NOT_FOUND2	Πλοήγηση στην οθόνη με τον επισημασμένο έλεγχο που εμφανίζεται παρακάτω.
MSG_STEP_LIGHT	Προεπισκόπηση Βήματος
MSG_STEP_NOT_FOUND	Βήμα καθοδηγούμενης περιήγησης δεν βρέθηκε.
MSG_STEP_NOT_FOUND_2	Κάντε κλικ στη γραμμή τίτλου της εφαρμογής στόχου ή πλοηγηθείτε στη δεξιά οθόνη.<br><br>Κάντε κλικ στο 'Προεπισκόπηση' για να δείτε την απαιτούμενη οθόνη.
PA_FINISHED	Η Πλοήγηση  Ολοκληρώθηκε.
PROJECT_TITLE	Τίτλος Εργου
TRAY_INFO_BUBBLE_HEADING	Βοηθός Διαδικασίας
TRAY_INFO_BUBBLE_TEXT	Το τρέχον βήμα δεν μπορεί να εμφανιστεί. Κάντε κλικ για περισσότερες πληροφορίες.
RESTRICTED_BUBBLE_HEADING	Ενέργεια Παρεμποδίστηκε
RESTRICTED_BUBBLE_TEXT	Δε μπορείτε να εκτελέσετε ενέργειες μέχρι να επιβεβαιωθεί το τρέχον βήμα
HELP_TITLE	Βοήθεια
HELP_INTRO	Η βοήθεια σας παρέχει επισκόπηση των κύριων τμημάτων και λειτουργιών του @{NAVIGATOR}.</br></br><b> Σημείωση:</b> Οι διαθέσιμες λειτουργίες εξαρτώνται από τις διαμορφώσεις των @{NAVIGATOR}.</br>
HELP_TITLE_DA	Πλευρική Μπάρα και Windows
HELP_SIDEBAR_T	Πλευρική μπάρα
HELP_SIDEBAR_H	Η πλευρική μπάρα σας επιτρέπει να ξεκινήσετε τις βασικές λειτουργίες του @{NAVIGATOR}. Για κάθε λειτουργία εμφανίζεται ένα κουμπί. Η πλευρική μπάρα μπορεί να μετακινηθεί χρησιμοποιώντας την μεταφορά και απόθεση, και μπορείτε να ελαχιστοποιήσετε και να μεγιστοποιήσετε με ένα κλικ το περίγραμμα της πλευρικής μπάρας.
HELP_CONTENT_CONTROL_T	Περιεχ.
HELP_CONTENT_CONTROL_H	Υποδεικνύει, αν το περιεχόμενο είναι διαθέσιμο. Ανοίγει το κύριο παράθυρο με το περιεχόμενο.
HELP_SEARCH_CONTROL_T	Αναζήτηση
HELP_SEARCH_CONTROL_H	Ανοίγει την αναζήτηση για αναζήτηση περιεχομένου.
HELP_EXTSEARCH_CONTROL_T	Εξωτερική Αναζήτηση
HELP_EXTSEARCH_CONTROL_H	Ανοίγει την αναζήτηση για αναζήτηση περιεχομένου.
HELP_STICKY_CONTROL_T	Προσθήκη Σημείωσης
HELP_STICKY_CONTROL_H	Προσθέτει ένα χαρτάκι σημείωσης για το τρέχον παράθυρο εφαρμογής. Μπορείτε να εισάγετε ένα κείμενο στο χαρτάκι της σημείωσης.
HELP_RECORDING_CONTROL_T	Έναρξη Καταγραφής
HELP_RECORDING_CONTROL_H	Ξεκινά την καταγραφή μίας διαδικασίας. Η καταγεγραμμένη διαδικασία θα αποθηκευτεί ως έγγραφο στην Περιοχή Χρήστη.
HELP_MAIN_WINDOW_T	Κύριο Παράθυρο
HELP_MAIN_WINDOW_H	Το κύριο παράθυρο εμφανίζει τα διαθέσιμα περιεχόμενα για το γενικό πλαίσιο συγκεκριμένης σελίδας.</br>Κατά τη διάρκεια της αναπαραγωγής της καθοδηγούμενης περιήγησης, το παράθυρο εμφανίζει τη λίστα με τα βήματα.
HELP_HEADER_T	Κεφαλίδα
HELP_HEADER_H	Το εικονίδιο κατάστασης στην κεφαλίδα υποδεικνύει αν τα περιεχόμενα είναι διαθέσιμα για το τρέχον γενικό πλαίσιο.
HELP_CONTENT_TAB_T	Περιεχόμενο Καρτέλας
HELP_CONTENT_TAB_H	Η καρτέλα δείχνει το διαθέσιμο περιεχόμενο για την τρέχουσα εφαρμογή.
HELP_CONTENT_VIEW_T	Προβολή Περιεχομένου
HELP_CONTENT_VIEW_H	Η προβολή περιεχομένου εμφανίζει τις διαθέσιμες πληροφορίες, λειτουργίες και τεκμηρίωση για το επιλεγμένο περιεχόμενο.</br>Μπορείτε να χρησιμοποιήσετε τον έλεγχο 'Πίσω' για να επιστρέψετε στην λίστα περιεχομένων.
HELP_SEARCH_TAB_T	Καρτέλα Αναζήτησης
HELP_SEARCH_TAB_H	ΣΤην καρτέλα μπορείτε να αναζητήσετε συγκεκριμένα περιεχόμενα για το τρέχον γενικό πλαίσιο.
HELP_INFO_TAB_T	Καρτέλα Πληροφοριών
HELP_INFO_TAB_H	Η καρτέλα εμφανίζει γενικές πληροφορίες σχετικά με τον @{NAVIGATOR}.
HELP_USERAREA_TAB_T	Καρτέλα Περιοχής Χρήστη
HELP_USERAREA_TAB_H	Η καρτέλα περιέχει τα έγγραφα της διαδικασίας καταγραφής. Μπορείτε να ανοίξετε, κάνετε κοινή χρήση ή διαγράψετε ένα έγγραφο. Μπορείτε να καταγράψετε περαιτέρω διαδικασίες.
HELP_INSTANT_T	Άμεση Βοήθεια
HELP_INSTANT_H	Με την ενεργοποιημένη ρύθμιση οι πρόσθετες θεματικές πληροφορίες εμφανίζονται δεξιά στην οθόνη της τρέχουσας εφαρμογής. Η ρύθμιση είναι ενεργοποιημένη από προεπιλογή.
HELP_REQCONTENT_T	Απαίτηση Περιεχομένων
HELP_REQCONTENT_H	Ανοίγει ένα παράθυρο e-mail για απαίτηση περιεχομένου που λείπει από τον δημιουργό.
HELP_SETTINGS_T	Ρυθμίσεις
HELP_SETTINGS_H	Η προβολή περιέχει ρυθμίσεις για την εμφάνιση του περιεχομένου @{NAVIGATOR}.
HELP_MYROLES_T	Οι Ρόλοι Μου
HELP_MYROLES_H	Αυτή η ρύθμιση εμφανίζει περιεχόμενο για τον αντιστοιχισμένο ρόλο.
HELP_WITHOUTROLES_T	Εμφάνιση Περιεχομένου Χωρίς Ρόλους
HELP_WITHOUTROLES_H	Αυτή η ρύθμιση εμφανίζει περιεχόμενο χωρίς αντιστοιχισμένους ρόλους.
HELP_EDITROLES_T	Ρόλοι
HELP_EDITROLES_H	Ολοι οι ρόλοι που χρησιμοποιήθηκαν για το περιεχόμενο εμφανίζονται και μπορούν να ενεργοποιηθούν ή να απενεργοποιηθούν για να εμφανίσουν το περιεχόμενο.
HELP_SHARECONTENT_T	Κοινή Χρήση Περιεχομένων
HELP_SHARECONTENT_H	Ανοίγει το πλαίσιο διαλόγου με τον σύνδεσμο στα περιεχόμενα. Ο σύνδεσμος μπορεί να χρησιμοποιηθεί και από άλλους χρήστες.
HELP_REQUESTCONTENT_T	Απαίτηση Περιεχομένων
HELP_REQUESTCONTENT_H	Ανοίγει προκαθορισμένο email για απαίτηση περιεχομένων για συγκεκριμένη περίπτωση.
HELP_PLAYBACK_CONTENT_T	Περιεχόμενα Αναπαραγωγής
HELP_PLAYBACK_CONTENT_H	Τα διαθέσιμα περιεχόμενα μπορούν να αρχίσουν ή να ανοίξουν με τα κουμπιά που βρίσκονται στο παράθυρο περιεχομένων.
HELP_MINIMIZED_STATUS_T	Κατάσταση Ελαχιστοποίησης
HELP_MINIMIZED_STATUS_H	Στην περίπτωση που κλείσετε το κύριο παράθυρο ένα κυμαινόμενο εικονίδιο κατάστασης θα υποδεικνύει αν τα περιεχόμενα είναι διαθέσιμα για το τρέχον γενικό πλαίσιο. Κάντε κλικ στο εικονίδιο για να επαναφέρετε το κύριο παράθυρο.
HELP_MINIMIZED_MENU_T	Θεματικό Μενού
HELP_MINIMIZED_MENU_H	Το θεματικό μενού (δεξί κλικ στο εικονίδιο) περιλαμβάνει λειτουργίες για την εμφάνιση του κύριου παραθύρου και της άμεσης βοήθειας.
HELP_BOOK_WINDOW_T	Παράθυρο Βιβλίου
HELP_BOOK_WINDOW_H	Το παράθυρο βιβλίου ανοίγει κατά την αναπαραγωγή του βιβλίου. Το κύριο παράθυρο και το παράθυρο περιεχομένων είναι κρυμμένα.
HELP_GOTOTOP	Μετάβαση στην αρχή
HELP_CAPTION	@{NAVIGATOR} Βοήθεια
NAVHELP_TITLE	Εικονίδιο Κατάστασης και Θεματικό Μενού
NAVHELP_INTRO	</br>Η βοήθεια σας παρέχει μία επισκόπηση του εικονιδίου κατάστασης και των καταχωρίσεων θεματικού μενού.
NAVHELP_STATUS_ICON_T	Εικονίδιο Κατάστασης (Γραμμή Εργασίας)
NAVHELP_STATUS_ICON_H	Το εικονίδιο κατάστασης τοποθετείται στην γραμμή εργασιών και εμφανίζει τις τρέχουσες δραστηριότητες του @{NAVIGATOR}. Υπάρχουν τρεις διαφορετικές καταστάσεις:
NAVHELP_STATUS_FOUND_T	Διαθέσιμα Περιεχόμενα (Πράσινο Εικονίδιο)
NAVHELP_STATUS_FOUND_H	Περιεχόμενα είναι διαθέσιμα για το τρέχον γενικό πλαίσιο και εμφανίζονται.
NAVHELP_STATUS_CHECK_T	Φόρτωση Περιεχομένου (Κίτρινο Εικονίδιο)
NAVHELP_STATUS_CHECK_H	@{NAVIGATOR} ελέγχει το τρέχον περιβάλλον για το διαθέσιμο περιεχόμενο και το φορτώνει.
NAVHELP_STATUS_NOFOUND_T	Μη Διαθέσιμα Περιεχόμενα (Κόκκινο Εικονίδιο)
NAVHELP_STATUS_NOFOUND_H	Περιεχόμενα δεν είναι διαθέσιμα για το τρέχον γενικό πλαίσιο.
NAVHELP_STANDBY_T	Απενεργοποιημένο
NAVHELP_STANDBY_H	@{NAVIGATOR} είναι ανενεργό. Ένα κλικ στο εικονίδιο κατάστασης (<i>CTRL + F11</i>) απενεργοποιεί ή απενεργοποιεί το @{NAVIGATOR}.
NAVHELP_STATUS_MIN_T	Ελαχιστοποίηση
NAVHELP_STATUS_MIN_H	Τα παράθυρα και η πλαϊνή γραμμή ελαχιστοποιούνται.
NAVHELP_STATUS_MENU_T	Θεματικό Μενού
NAVHELP_STATUS_MENU_H	Το θεματικό μενού (με δεξί κλικ στο εικονίδιο) περιλαμβάνει τις γενικές λειτουργίες του @{NAVIGATOR}.
NAVHELP_VERSION_T	Εμφάνιση Εκδοσης
NAVHELP_VERSION_H	Εμφάνιση του αριθμού έκδοσης του εγκατεστημένου @{NAVIGATOR}. Αυτό είναι απαραίτητο για οποιαδήποτε επικοινωνία με την υποστήριξη στην περίπτωση που προκύψει πρόβλημα.
NAVHELP_JSCONSOLE_T	Κονσόλα JavaScript
NAVHELP_JSCONSOLE_H	Εμφανίζει την Κονσόλα JavaScript που παρουσιάζει τα λεπτομερή μηνύματα σφάλματος. Αυτό είναι απαραίτητο για οποιαδήποτε επικοινωνία με την υποστήριξη στην περίπτωση που προκύψει πρόβλημα.
NAVHELP_NAV_CACHE_T	Διαγραφή Κρυφής Μνήμης
NAVHELP_NAV_CACHE_H	Διαγράφει την τοπική cahce του περιεχομένου @{NAVIGATOR}.
NAVHELP_RESET_HIDDEN_T	Εμφάνιση Κρυμμένης Βοήθειας Ξανά
NAVHELP_RESET_HIDDEN_H	Επαναφέρει στοιχεία βοήθειας που ορίστηκαν στο 'Κρυμμένο' κατά την διάρκεια της αναπαραγωγής.
NAVHELP_EXIT_T	Εξοδος
NAVHELP_EXIT_H	Διακόπτει την αναπαραγωγή και κλείνει το @{NAVIGATOR}.
IDS_NAVP_ABOUT	Εμφάνιση Εκδοσης...
IDS_NAVP_CONSOLE	Κονσόλα JavaScript...
IDS_NAVP_DELETE_CACHE	Διαγραφή Κρυφής Μνήμης
IDS_NAVP_HOOKER	Hooker
IDS_SEARCH_INPUT	Περιεχόμενο Βοήθειας Αναζήτησης
IDS_CLEAR_SEARCH	Εκκαθάριση Αναζήτησης
IDS_NAVP_CLOSE	Εξοδος
IDS_RESET_CURRENT	Εμφάνιση Κρυμμένου Στοιχείου Βοήθειας πάλι
IDS_RESET_ALL	Εμφάνιση Κρυμμένης Βοήθειας Ξανά
IDS_RESET_ALL_TIP	Εμφάνιση όλων των ανενεργών στοιχείων ξανά κατά την εισαγωγή μίας οθόνης για πρώτη φορά.
IDS_OPEN_RECORD_LBL	Ανοικτό
IDS_EDIT_RECORD_LBL	Μετονομασία
IDS_DELETE_RECORD_LBL	Διαγραφή
IDS_SHARE_RECORD_LBL	Κοινή χρήση
IDS_EXTERNAL_SEARCH_BTN	Εξωτερική Αναζήτηση
IDS_EXTERNAL_SEARCH_SUB_MENU	Εξωτερική Αναζήτηση
IDS_SHOW_SCREEN_ICON	Εμφάνιση Βοηθού Επιφάνειας Εργασίας
IDS_SHOW_DA	Εμφάνιση Κύριου Παραθύρου
IDS_SHOW_CONTENT	Εμφάνιση Περιεχομένων
IDS_HIDE_CONTENT	Απόκρυψη Περιεχομένου
IDS_SEARCH_BTN	Αναζήτ
IDS_REQUEST_CONTENT_BTN	Απαίτηση Περιεχομένων
IDS_RECORDING_BTN	Έναρξη Καταγραφής
IDS_SHOW_CA_SWITCH	Εμφάνιση Άμεσης Βοήθειας
IDS_HIDE_CA_SWITCH	Απόκρυψη Αμεσης Βοήθειας
IDS_CA_SWITCH_INACTIVE_BTN	Άμεση Βοήθεια Μη Διαθέσιμη
IDS_DO_CTX_RECOGNITION	Εμφάνιση Άμεσης Βοήθειας
IDS_NAV_STANDBY	@{NAVIGATOR} απενεργοποιήθηκε.
IDS_NAV_NO_STANDBY	@{NAVIGATOR} ενεργοποιήθηκε.
IDS_SHOW_DA_PANELS	@{NAVIGATOR} είναι διαθέσιμη πάλι. Μπορείτε να χρησιμοποιήσετε @{NAVIGATOR} αν χρειάζεστε κάποια βοήθεια.
IDS_HIDE_DA_PANELS	@{NAVIGATOR} Καταργήθηκε αυτόματα καθώς κατάλληλη βοήθεια είναι διαθέσιμη στην εφαρμογή που ανοίξατε πρόσφατα. Απλά ανοίξτε τη βοήθει στην εφαρμογή αν χρειάζεστε περαιτέρω βοήθεια.
IDS_ADD_STICKY_NOTES_BTN	Προσθήκη Σημείωσης
IDS_ADD_STICKY_NOTES_INACTIVE_BTN	Μπορείτε να προσθέσετε μόνο μία σημείωση για αυτήν την εφαρμογή.
IDS_EXIT_DA	Εξοδος
IDS_EXIT_DA_BTN	Εξοδος
IDS_EXIT_DA_SUB_MENU	Εξοδος
IDS_SHOW_MORE	Εμφάνιση Περισσότερων
IDS_HIDE_MORE	Απόκρυψη Περισσότερων
IDS_REQUEST_CONTENT_SUB_MENU	Απαίτηση Περιεχομένων
IDS_SHOW_CA_SUB_MENU	Εμφάνιση Άμεσης Βοήθειας
IDS_HIDE_CA_SUB_MENU	Απόκρυψη Αμεσης Βοήθειας
IDS_ADD_STICKY_NOTE_SUB_MENU	Προσθήκη Σημείωσης
IDS_RECORDING_SUB_MENU	Έναρξη Καταγραφής
IDS_CA_SWITCH_SUB_MENU	Θεματική Βοήθεια
IDS_SHARE_DLG_CAPTION	Κοινή Χρήση Εγγράφου
IDS_DELETE_FRAMES	Διαγραφή Πλαισίων
OPEN_FOLDER	Ανοιγμα φακέλου
SHARE_DOC	Κοινή χρήση μέσω Email
IDS_SHARE_DLG_TEXT	Τι θα θέλατε να κάνετε ;
IDS_SEARCH_BTN_SUB_MENU	Περιεχόμενο Αναζήτησης
IDS_LIBRARY_SEARCH_BTN_SUB_MENU	Αναζήτηση Περιεχομένου στην βιβλιοθήκη
GRACEFUL_DEGRADATION	Αυτή η ιδιότητα είναι προσωρινά μη διαθέσιμη λόγω προβλημάτων δικτύου \n\n Προσπαθήστε ξανά αργότερα.
SHARE_BTN	Κοινή χρήση μέσω Email
COPY_BTN	Αντιγραφή Σύνδεσης
SHARE_MAIL_SUBJECT	Προτεινόμενα Περιεχόμενα
SHARE_MAIL_HEADER	Αγαπητέ Χρήστη, \n\nΑυτά τα περιεχόμενα μπορεί να σας ενδιαφέρουν. \n\n
SHARE_MAIL_FOOTER	Με Εκτίμηση,
SHARE_MAIL_LINK	Σύνδεσμος:\t
SHARE_MAIL_CAPTION	Λεζάντα:\t
SHARE_TITLE	Κοινή Χρήση Περιεχομένων
SELECT_ASSET	Επιλογή ενός παγίου για έναρξη.
ENTER_NAME	Εισάγετε ένα όνομα
DELETE_RECORD_WRN	Σημαντικό: Αυτή η ενέργεια δεν μπορεί να ακυρωθεί.
MSG_PA_NEXT_LBL	Επόμενο
MSG_PA_STEP_LBL	Λίστα Βημάτων
TOGGLE_STEPLIST_TOOLTIP	Εμφάνιση / Απόκρυψη Λίστας Βημάτων
PREVIEW_STEP_TOOLTIP	Προεπισκόπηση βήματος
NEXT_STEP_TOOLTIP	Προς Επόμενο Βήμα
PREV_STEP_TOOLTIP	Μετάβαση σε Προηγούμενο Βήμα
ROLES_TITLE	Ρόλοι Desktop Assistant
ROLES_LBL	Φιλτράρισμα Περιεχομένου Βοήθειας κατά Ρόλο
OK_CAPTION	ΟΚ
CANCEL_CAPTION	Ακύρωση
BTN_YES	Ναι
BTN_NO	Οχι
DELETE_CONFIRM	Είστε βέβαιοι ότι θέλετε να διαγράψετε αυτή την αυτοκόλλητη σημείωση;
EXIT_CONFIRM	Θέλετε να βγείτε από το @{NAVIGATOR};
sticky_notes	Σημειώσεις
exit_da	Έξοδος @{NAVIGATOR}
STICKY_NOTE_DEFAULT_TEXT	Προσθήκη κειμένου εδώ.
SEARCH_BTN_TOOLTIP	Αναζήτηση
NEXT_BTN_TOOLTIP	Επόμενο
PREV_BTN_TOOLTIP	Προηγ.
HIDE_BTN_TOOLTIP	Απόκρυψη Καρουζέλ
IDS_PRJ_NAME	Εισαγωγή Ονόματος
IDS_APPLICATIONS	Επιλογή Παραθύρου:
IDS_PRJ_LANGUAGE	Επιλογή Γλώσσας:
IDS_FULL_SCREEN	Πλήρης Οθόνη
IDS_CHOOSE_APP_CAPTION	Επιλογή Εφαρμογής
IDS_RECORD_BTN	Καταγραφή
IDS_ANALYZE_ACTIONS	Ανάλυση ενεργειών...
IDS_PARSE_PROJECT	Ανάλυση έργου...
IDS_REGION	Περιοχή
IDS_AREA_HELP	Αλλαγή του μεγέθους περιοχής επιλέγοντας ένα από τα παρακάτω πρότυπα. Ρυθμίστε το κόκκινο ορθογώνιο για να επιλέξετε μία περιοχή ή επιλέξτε πλήρη οθόνη.
IDS_CHOOSE_SIZE	Επιλογή Μεγέθους
IDS_DEFINE_REC_AREA	Περιοχή Καταγραφής
IDS_DEFINE_NAME_LANG	Δημιουργία Περιεχομένου
PLEASE_SELECT	Παρακαλώ επιλέξτε
quick_recorder.help_caption	Συμβουλές
quick_recorder.help	Χρήση «ΠΑΥΣΗ» για παύση ή συνέχεια. \nΧρήση «ΤΕΛΟΣ» για ολοκλήρωση.\n\nΠατήστε  «ΟΚ» για να ξεκινήσει η εγγραφή.
quick_recorder.audio_help	Χρήση «ΠΑΥΣΗ» για παύση ή συνέχεια. \n Χρήση «ΤΕΛΟΣ» για ολοκλήρωση. \n\nΉχος:\nΟ ήχος σας δεν καταγράφηκε στη διάρκεια του κλικ. Πείτε το κείμενό σας πριν επιλέξετε έναν έλεγχο audio. \n\nΠατήστε  «ΟΚ» για να ξεκινήσει η εγγραφή.
FILE_EXISTS	Αρχείο με το ίδιο όνομα υπάρχει ήδη. Εισάγετε διαφορετικό όνομα.
HELP_EXIT_CONTROL_H	Διακόπτει την αναπαραγωγή και κλείνει το @{NAVIGATOR}.
HELP_EXIT_CONTROL_T	Εξοδος
BTN_CLOSE_DLG	Κλείσιμο
DELETE_RECORD_WRN	Σημαντικό: Αυτή η ενέργεια δεν μπορεί να ακυρωθεί.
ENTER_NAME	Εισάγετε ένα όνομα
IDS_CLEAR_SEARCH	Εκκαθάριση Αναζήτησης
IDS_RESET_ALL_TIP	Εμφάνιση όλων των ανενεργών στοιχείων ξανά κατά την εισαγωγή μίας οθόνης για πρώτη φορά.
IDS_SEARCH_INPUT	Περιεχόμενο Βοήθειας Αναζήτησης
LBL_DELETE	Διαγραφή
LBL_NAVI_NO_MATCH	Δεν υπάρχουν αποτελέσματα για την αναζήτησή σας.
LBL_TU	Ανοικτό
MSG_PA_NEXT_LBL	Επόμενο
MSG_PA_STEP_LBL	Λίστα Βημάτων
RENAME_FAILED	Λειτουργία μετονομασίας απέτυχε.
ROLES_LBL	Φιλτράρισμα Περιεχομένου Βοήθειας κατά Ρόλο
SELECT_ASSET	Επιλογή ενός παγίου για έναρξη.
LBL_CDOC	Ανοικτό
LBL_RECORD_DOCUMENT	Eγγραφή Αρχείου
QR_CAPTION	Επιλογή Εξόδου από Καταγραφή
QR_WELCOME	Τι θέλετε να δημιουργήσετε;
QR_DOC_CAP	Έγγραφο
QR_DOC_TXT	Δημιουργεί έγγραφο Microsoft Word που εμφανίζει ένα στιγμιότυπο οθόνης και κείμενο οδηγιών για κάθε ενέργεια που καταγράφετε.
QR_VIDEO_CAP	Βίντεο
QR_VIDEO_TXT	Δημιουργεί βίντεο υψηλής ποιότητας της καταγραφής σας
QR_DOC_VIDEO_CAP	Έγγραφο και Βίντεο
QR_DOC_VIDEO_TXT	Δημιουργεί έγγραφο και βίντεο.
SHARE_ERR_CAP	Αδύνατη κοινή χρήση καταγραφής
SHARE_ERR_TXT	Αυτή η καταγραφή είναι πολύ μεγάλη για να την στείλετε με email.\nΘέλετε να ανοίξετε την τοποθεσία αρχείου;
HELP_CONTENT_WINDOW_H	Το παράθυρο περιεχομένων εμφανίζει τις διαθέσιμες πληροφορίες, λειτουργίες και την τεκμηρίωση για τα επιλεγμένα περιεχόμεαν του κύριου παραθύρου.</br>Το παράθυρο περιεχομένων μπορεί να τοποθετηθεί στο κύριο παράθυρο, που σας επιτρέπει να μετακινήσετε και τα δύο παράθυρα μαζί στην οθόνη.
HELP_CONTENT_WINDOW_T	Παράθυρο Περιεχομένων
IDS_CONTENT_BTN	Περιεχ.
MSG_PA_STEP_NOT_FOUND_NUMERAL_1	1.
MSG_PA_STEP_NOT_FOUND_NUMERAL_2	2.
SHARE_URL	URL τρέχουσας σελίδας:
